11111111111
100010C0001
10P00000C01
11111000001
1000100E011
11111111111