111111111111111111111111
1000P000000000000C000001
100000000001000000000001
101111000000000000000001
100000000000000001000001
1111111000000C00101C0001
100000000000000001000001
100C00000000011100000001
100000000000000C00000001
1000E0000000000000000011
100000000000000000000001
111111111111111111111111