11111111
1P00C001
10000001
100000E11111111
11111111