11111111111
100P0010001
111000C0001
1C100000E01
11111111111