11111111
0P00C001
0C000001
100C0E01
11111111