11111111
1P100001
11100C01
100000E1
11111111